e,e,e,e,e,e,e,e,e,e,e,e,e,e,e
e,e,e,e,e,e,e,e,e,e,e,e,e,e,e
e,e,e,e,e,e,e,e,e,e,e,e,e,e,e
e,e,e,e,e,e,e,b,e,e,e,e,e,e,e
e,e,e,e,e,e,e,b,b,e,e,e,e,e,e
e,e,e,e,e,e,e,b,e,e,e,e,e,e,e
e,e,e,e,e,e,e,e,e,e,e,e,e,e,e
b,e,e,e,e,e,e,e,e,d,e,e,e,e,e
b,b,e,e,e,e,e,e,e,e,e,e,e,e,e
b,b,b,e,e,e,e,e,e,e,e,e,e,e,e
